F 139,99,58
C 171,154,137

NO textures/simonkraft/bookshelf.xpm
SO textures/simonkraft/bookshelf.xpm
WE textures/simonkraft/bookshelf.xpm
EA textures/simonkraft/bookshelf.xpm

1111111111111111111
1001001000001001001
100000000W000000001
1000010011111000001
1111000000000001111
1000000101010000001
1111111111111111111

