F 76,76,76
C 99,99,99

NO textures/no_wall.xpm
SO textures/so_wall.xpm
WE textures/we_wall.xpm
EA textures/ea_wall.xpm

11111111111111111111111111111111111111111111111
100000000000000000000000000E0000000000000000001
10000000000000000000000000000000000000000000001
100000000000000001111111111D1111111111111111111
10000000000000000000000000000000000000000000001
10000000000000000000000000000000000000000001001
10000000000000000000000000000000000000000001001
10000000000000000000000000000000000000000001001
10000000000000000000000000000000000000000001001
10000000000000000000000000000000000000000001001
10000000000000000000000000000000000000000001001
10000000000000000000000000000000000000000001001
10000000000000000000000000000000000000000001001
10000000000000000000000000000000000000000000001
11111111111111111111111111111111111111111111111

