WE textures/wolfenstein/eagle.xpm
NO textures/wolfenstein/grey_stone.xpm
SO textures/wolfenstein/red_brick.xpm
EA textures/wolfenstein/mossy.xpm

F 69,222,199
C 235,198,52

111111111111111111111111111
100000000000001000000000001
101111111111101011111111101
101000000001101010000001101
1010D1111101101011111101101
100010000001000000000001001
1110111011111D1111101110111
100000001000000000001000001
101111101011111D11101011101
10100000D010000000001010001
101011111010111111101011101
1010100000001000D0000010001
101010D1111110D1111D1111101
1000001000000010000000000N1
111111111111111111111111111
